20,15
XXXXXXXXXXXXXXXXXXXX
X X   X   XX     XsX
X   X   X  X XXXXX X
XX XXX XXX X X   X X
X    X X   X   X   X
X XX X X XXX XXXXXXX
X    X X   X   X   X
XXX XXXXXXEXXX   XXX
X   X    XXX   X   X
X XXX X XX   XXX XXX
X   X X  X X   X   X
X X X   XXXX XXXXX X
X X X X  X   X   X X
X     XX   X X X   X
XXXXXXXXXXXXXXXXXXXX