10,10
XXXXXXXXXX
XsX      X
X X X XXXX
X   X   XX
XX XXXX  X
X   X   XX
X X X X  X
XXX X XX X
X   X  X X
XXXXXXEXXX