7,5
XXXXXEX
XsXX  X
X  X XX
X     X
XXXXXXX