6,7
XXXXXX
Xs   X
XXXX X
X EX X
X XX X
X    X
XXXXXX