20,15
XXXXXXXXXXXXXXXXXXXX
X X   X   X   X   sX
X X X X X X X X X XX
X   X   X   X   X  X
X XXXXXXXXXXXXXXXXXX
X    X   X   X   X X
XX X X X X X X X X X
X  X   X   X   X   X
XXXXXXXXXXXXXXXXX XX
X X   X   X   X    X
X X X X X X X X X XX
X   X   X   X   X  X
XX XXXXXXXXXXXXXXXXX
X                  E
XXXXXXXXXXXXXXXXXXXX